W,W,W,W,W,W
W,W,G,G,W,W
W,W,F,P,W,W
W,F,F,F,F,W
W,F,B,B,F,W
W,F,F,F,F,W
W,W,W,W,W,W