W,W,W,W,W,W,W,W
W,W,W,F,F,F,W,F
W,G,P,B,F,F,W,W
W,W,W,F,B,G,W,W
W,G,W,W,B,F,W,W
W,F,W,G,G,F,W,W
W,B,F,B,B,B,G,W
W,F,F,F,G,F,F,W
W,W,W,W,W,W,W,W