F,F,F,F,F,W,W,W,W,W,W,W,F
F,F,F,F,W,W,F,F,F,F,F,W,F
F,W,W,W,W,F,F,W,W,F,F,W,F
W,W,F,F,F,F,F,F,W,B,W,W,F
W,F,B,F,B,F,F,B,W,F,W,W,W
W,F,W,F,W,W,B,F,W,F,F,F,W
W,F,W,F,F,W,F,F,B,F,F,F,W
W,G,G,G,F,W,F,F,F,W,W,W,W
W,G,P,G,F,W,W,W,W,W,F,F,W
W,W,G,F,W,W,F,F,F,F,F,F,W
F,W,W,W,W,F,F,F,F,F,F,F,F
F,F,W,W,F,F,F,F,W,W,W,W,W
W,W,W,W,F,W,W,F,W,W,W,W,W