W,W,W,W,W,W,W,W,W,W,W,W,W
W,W,W,W,W,W,W,W,W,W,W,W,W
W,W,W,W,W,W,W,W,W,W,W,W,F
W,G,G,F,F,W,F,F,F,F,F,W,W
W,G,G,F,F,W,F,B,F,F,B,F,F
W,G,G,F,F,W,B,W,W,W,W,F,F
W,G,G,F,F,F,F,P,F,W,W,F,F
W,G,G,F,F,W,F,W,F,F,B,F,W
W,W,W,W,W,W,F,W,W,B,F,B,F
F,F,W,F,B,F,F,B,F,B,F,B,F
F,F,W,F,F,F,F,W,F,F,F,F,F
F,F,W,W,W,W,W,W,W,W,W,W,W
W,W,W,W,W,W,W,W,W,W,W,W,W